a,b,c,d,eig1,eig2,sum_squared,predicted_sum_squared,trace,det,symmetry
-9,-7,-2,-1,-10.477225575051662,0.4772255750516609,110.00000000000004,109.5128943847832,-10,-5,5
10,-9,-7,7,16.577747210701755,0.4222527892982439,274.99999999999994,274.79583915097385,17,7,2
-9,6,-4,1,-5.000000000000001,-3.0,34.00000000000001,37.72021067734943,-8,15,10
10,-8,-10,2,15.797958971132712,-3.797958971132712,264.00000000000006,264.5828434698123,12,-60,2
-6,2,7,-1,-8.0,1.0,65.0,62.16106413855102,-7,-8,5
-10,-9,2,1,-8.0,-1.0,65.0,65.0288184952792,-9,8,11
8,1,7,-1,8.720153254455274,-1.7201532544552751,78.99999999999999,79.77378663339498,7,-15,6
-9,2,3,2,-9.520797289396148,2.520797289396148,97.0,93.04808927030321,-7,-24,1
-7,-2,-1,8,-7.1321687612368745,8.132168761236874,117.0,116.58726320831487,1,-58,1
-7,8,6,-4,-12.588723439378914,1.5887234393789118,161.0,161.36145389422524,-11,-20,2
6,-8,0,9,6.0,9.0,117.0,112.34776730528382,15,54,8
8,-2,-7,3,10.0,1.0,101.0,100.70980314970733,11,10,5
-1,2,-6,-9,-3.0,-7.0,58.0,54.542610966882904,-10,21,8
3,1,1,2,3.618033988749895,1.381966011250105,15.0,16.73862618700051,5,5,0
-6,-1,-5,0,-6.741657386773941,0.7416573867739414,45.99999999999999,46.1657220656483,-6,-5,4
-5,-10,-7,-3,-12.42614977317636,4.426149773176358,174.0,174.90869128147256,-8,-55,3
3,-1,-5,3,5.23606797749979,0.7639320225002102,28.0,26.728420322898646,6,4,4
-3,6,4,-8,0.0,-11.0,121.0,116.64588260906264,-11,0,2
-6,7,3,6,-7.54983443527075,7.54983443527075,114.0,113.97947305215655,0,-57,4
8,0,0,2,8.0,2.0,68.0,66.08530076756846,10,16,0
-9,10,8,-4,-15.787087810503357,2.7870878105033547,257.0,256.29987908239127,-13,-44,2
8,3,-8,-3,5.0,0.0,25.0,23.28237291354174,5,0,11
-8,-4,-9,1,-11.0,4.0,137.0,138.80492225876145,-7,-44,5
-4,-3,10,10,-1.358898943540673,7.358898943540673,55.99999999999999,56.50864454451149,6,-10,13
-1,-8,-3,-5,2.291502622129181,-8.291502622129181,74.0,75.8280479879382,-6,-19,5
-6,8,3,5,-7.865459931328118,6.865459931328118,109.0,108.03376516592016,-1,-54,5
4,-5,0,6,4.0,6.0,52.0,48.44116034297361,10,24,5
6,-10,-3,-6,8.12403840463596,-8.12403840463596,132.00000000000003,132.2496591316993,0,-66,7
8,-10,-1,4,9.74165738677394,2.2583426132260587,100.0,100.26066536474436,12,22,9
4,-5,-4,-5,5.844288770224761,-6.84428877022476,81.0,82.392800304442,-1,-40,1
-6,-7,-9,-6,1.937253933193772,-13.937253933193771,198.00000000000009,201.381103818894,-12,-27,2
0,3,2,-2,1.6457513110645907,-3.645751311064591,16.0,16.40724844732447,-2,-6,1
4,4,9,3,9.520797289396146,-2.5207972893961488,96.99999999999996,97.27577158600118,7,-24,5
5,0,1,-4,-4.0,5.0,41.0,39.62459115241085,1,-20,1
-3,-4,-9,-2,-8.520797289396146,3.5207972893961488,84.99999999999999,87.33441241787932,-5,-30,5
-2,-6,-8,-8,2.54983443527075,-12.54983443527075,164.0,164.90137808702164,-10,-32,2
0,2,3,-4,1.162277660168379,-5.162277660168379,28.0,28.093655509834242,-4,-6,1
-10,7,2,6,-10.831760866327848,6.831760866327847,164.0,163.03135139429122,-4,-74,5
4,1,-7,-2,2.414213562373095,-0.4142135623730949,6.0,4.2466122737172975,2,-1,8
-4,1,9,3,-5.109772228646444,4.109772228646444,43.0,43.528942585074596,-1,-21,8
8,-3,0,0,8.0,0.0,64.0,63.355501076936896,8,0,3
2,-9,-10,-7,8.000000000000002,-13.0,233.00000000000003,231.95374615845105,-5,-104,1
-6,-6,3,9,-4.68465843842649,7.68465843842649,80.99999999999999,82.18774910458076,3,-36,9
-7,2,2,1,-7.47213595499958,1.4721359549995794,58.0,60.472739678825825,-6,-11,0
-3,5,2,-4,-0.2984378812835757,-6.701562118716424,45.0,45.38383186155817,-7,2,3
-9,-10,-5,-7,-15.141428428542849,-0.8585715714571487,230.0,231.66312240607533,-16,13,5
-6,10,6,0,-11.306623862918077,5.306623862918075,156.0,156.81597919456354,-6,-60,4
9,-4,-8,-3,11.24621125123532,-5.246211251235321,154.0,154.1062730567055,6,-59,4
-9,-1,5,1,-8.47213595499958,0.4721359549995794,72.0,72.09425385495548,-8,-4,6
5,-6,1,-6,4.42442890089805,-5.424428900898052,48.99999999999997,50.958394395728575,-1,-24,7
5,9,0,2,5.0,2.0,29.0,29.297276132368903,7,10,9
-9,-10,-6,-5,-15.0,1.0,226.0,228.67888857338872,-14,-15,4
-2,0,-2,-7,-7.0,-2.0,53.0,52.800168247321686,-9,14,2
-10,3,3,0,-10.8309518948453,0.8309518948453004,118.0,116.3029014816262,-10,-9,0
0,9,6,-8,4.366600265340756,-12.366600265340756,172.00000000000003,170.68158936072064,-8,-54,3
-5,3,4,1,-6.58257569495584,2.58257569495584,49.99999999999999,50.759559344399605,-4,-17,1
-8,5,5,0,-10.403124237432849,2.4031242374328485,114.0,112.80171095622386,-8,-25,0
3,-2,-9,5,-0.3588989435406731,8.358898943540673,70.0,67.67951015869077,8,-3,7
-2,10,8,-8,4.433981132056603,-14.433981132056603,228.00000000000003,228.08585283161688,-10,-64,2
7,10,1,-9,7.602325267042627,-9.602325267042628,150.0,152.53229645955707,-2,-73,9
5,5,-7,-7,-1.7763568394002505e-15,-1.9999999999999991,3.999999999999997,5.203511824937583,-2,0,12
9,3,1,-8,9.174675786448738,-8.174675786448736,151.0,148.59983010075013,1,-75,2
-6,9,3,10,-7.539392014169458,11.539392014169456,190.00000000000003,188.98611870330524,4,-87,6
-5,1,-10,3,-3.4494897427831788,1.4494897427831783,14.000000000000004,11.406266214288399,-2,-5,11
-7,0,4,10,10.0,-7.0,149.0,149.97101389817274,3,-70,4
-1,-2,-2,1,-2.23606797749979,2.23606797749979,10.000000000000002,11.846335882769216,0,-5,0
-3,-3,-2,2,-4.0,3.0,25.0,26.018258477224453,-1,-12,1
-10,10,8,6,-14.0,10.0,296.0,293.5495707449857,-4,-140,2
-8,2,-2,7,-7.72841614740048,6.72841614740048,105.0,104.64208980778348,-1,-52,4
1,3,-3,9,2.3542486889354093,7.645751311064591,64.0,63.66591066174473,10,18,6
4,0,-10,2,2.0,4.0,20.0,21.15755847030966,6,8,10
-6,0,-8,4,4.0,-6.0,52.0,52.36816567450469,-2,-24,8
8,10,-3,-6,5.358898943540673,-3.358898943540673,39.99999999999999,39.998435282241736,2,-18,13
3,7,1,-5,3.795831523312719,-5.795831523312719,47.99999999999999,47.23143101068204,-2,-22,6
4,9,2,-2,6.196152422706632,-4.196152422706632,56.0,55.19452739783607,2,-26,7
8,-1,6,-8,7.615773105863909,-7.615773105863909,116.0,115.1133655052536,0,-58,7
-6,7,9,5,-10.156603957913983,9.156603957913983,187.0,187.86768484724715,-1,-93,2
4,10,9,-2,10.9498743710662,-8.949874371066198,200.0,199.53142048486092,2,-98,1
-2,7,-1,7,-1.1400549446402586,6.140054944640259,38.99999999999999,40.19505232001293,5,-7,8
-6,-1,1,4,-5.898979485566356,3.898979485566356,50.0,49.794015745612576,-2,-23,2
-9,-3,-3,-2,-10.109772228646444,-0.8902277713535562,103.0,96.356624631667,-11,9,0
-3,4,-4,5,1.0000000210734243,0.9999999789265758,2.000000000000001,1.1288855727088196,2,1,8
10,1,4,-3,10.300735254367725,-3.300735254367721,117.00000000000004,118.7751784004764,7,-34,3
-1,-3,-4,-1,2.4641016151377544,-4.464101615137755,26.000000000000004,25.240149508204833,-2,-11,1
-6,1,5,-1,-6.854101966249685,-0.1458980337503155,47.0,45.91053511246806,-7,1,4
-5,7,3,8,-6.452986860293432,9.452986860293434,131.0,129.79233565761456,3,-61,4
-6,9,5,-9,-0.6261364575662398,-14.37386354243376,207.0,207.46090394226525,-15,9,4
8,3,-8,-4,5.4641016151377535,-1.4641016151377544,31.99999999999999,30.698024175935306,4,-8,11
8,-2,-3,-9,8.345903006477066,-9.345903006477066,157.0,157.06921539786921,-1,-78,1
0,7,1,-9,0.7201532544552744,-9.720153254455274,95.0,96.89542749729556,-9,-7,6
1,2,7,0,4.274917217635375,-3.274917217635375,29.0,30.66058589014295,1,-14,5
-1,7,5,0,-6.437171043518958,5.437171043518959,71.0,68.6484827010139,-1,-35,2
-1,2,-1,-8,-1.2984378812835755,-7.701562118716424,61.0,61.25781912775233,-9,10,3
7,0,-5,-9,-9.0,7.0,130.0,129.67170078248765,-2,-63,5
-1,-4,-7,4,-4.352349955359813,7.352349955359813,73.0,73.01415663961,3,-32,3
-5,8,5,-9,-0.3667504192892004,-13.6332495807108,186.0,184.38405209034477,-14,5,3
1,-7,-6,1,7.48074069840786,-5.48074069840786,86.0,85.5256029028463,2,-41,1
-6,-8,-8,10,-9.31370849898476,13.31370849898476,264.0,265.64166142057456,4,-124,0
-1,7,2,-8,0.6234753829797981,-9.6234753829798,93.0,91.26350617591565,-9,-6,5
-8,8,-3,6,-6.0,4.0,52.0,52.42149777706298,-2,-24,11
